#+TITLE: Books
#+AUTHOR: Thiago Araujo
#+YEAR: 2026

* *Reading*

** *Físicos*
- Filosofia  : História da Filosofia, vol. 1 - Copleston
- Religião   : O Sagrado e o Profano - Mircea Eliade
- Matemática : Princíopios de Combinatória e Probabilidade - Tertuliano Franco
- Política   : Nietzsche, O Rebelde Aristocrata - Domenico Losurdo

** *Ebooks Kindle*
- História   : The History of the World - Jeremy Black
- Filosofia  : Convite a Filosofia - Marilena Chauí
- Gregos     : Teogonia - Hesíodo
- Brasileiro : Triste Fim de Policarpo Quaresma - Lima Barreto
- Outros     : Você não merece ser feliz - Craque Daniel

* *To Read*

** *Kindle*

*** Greeks
- Iliada - Homero
- Odisseia - Homero
- Histórias - Herodoto
- História da Guerra do Poloponeso - Tucidides
- Helenicas - Xenofonte

** *To Buy*

- Marx e a História - Gustavo Machado
- Marx e a Filosofia - Gustavo Machado
- O Sonho De Um Homem Ridículo - Fiódor Dostoiévski
- A morte de Ivan Ilitch, Liev Tolstói
- O Capote - Gogol
- Diario de um louco - Gogol

* *Read - 2026*

- Política   : Do Socialismo Utopico ao Socialismo Científico - Engels
- Classico   : Histórias Verdadeiras - Luciano de Samósata
